333333333
310002333
303330333
323330333
323330333
300000333
333333333
333333333
333333333