333333333
310023333
303303333
303303333
320020023
333303303
333303303
333320023
333333333