333333333
333333013
333333003
333300003
320200023
300033303
300033303
320200023
333333333